OOOOOOOOO
OOXOXXOXO
XOXOXOOOX
XOOXOOXOO
OOXOOXXOX
XOOXSXOOX
OOXOOOXOO
OXXOXOXOX
OOOOXOOOE